115 115 115 115 115 115 115 115 115 115 115 115 115 115 115 115 115 115 115 115 115 115 115 115 115 115 115 115 115 115 115 115 115 115 115 115 115 115 115 115 115 115 115 115 115 115 115 115 115 115 
115 115 115 115 115 115 115 115 115 115 115 115 115 115 115 115 115 115 115 115 115 115 115 115 115 115 115 115 115 115 115 115 115 115 115 115 115 115 115 115 115 115 115 115 115 115 115 115 115 115 
115 115 115 115 115 115 115 115 115 115 115 115 115 115 115 115 115 115 115 115 115 115 115 115 115 115 115 115 115 115 115 115 115 115 115 115 115 115 115 115 115 115 115 115 115 115 115 115 115 115 
115 115 115 115 115 115 115 115 115 115 115 115 115 115 115 115 115 115 115 115 115 115 115 115 115 115 115 115 115 115 115 115 115 115 115 115 115 115 115 115 115 115 115 115 115 115 115 115 115 115 
115 115 115 115 115 115 115 115 115 115 115 115 115 115 115 115 115 115 115 115 115 115 115 115 115 115 115 115 115 115 115 115 115 115 115 115 115 115 115 115 115 115 115 115 115 115 115 115 115 115 
115 115 115 115 115 115 115 115 115 115 115 115 115 115 115 115 115 115 115 115 115 115 115 115 115 115 115 115 115 115 115 115 115 115 115 115 115 115 115 115 115 115 115 115 115 115 115 115 115 115 
115 115 115 115 115 115 115 115 115 115 115 115 115 115 115 115 115 115 115 115 115 115 115 115 115 115 115 115 115 115 115 115 115 115 115 115 115 115 115 115 115 115 115 115 115 115 115 115 115 115 
115 115 115 115 115 115 115 115 115 115 115 115 115 115 115 115 115 115 115 115 115 115 115 115 115 115 115 115 115 115 115 115 115 115 115 115 115 115 115 115 115 115 115 115 115 115 115 115 115 115 
115 115 115 115 115 115 115 115 115 115 115 115 115 115 115 115 115 115 115 115 115 115 115 115 115 115 115 115 115 115 115 115 115 115 115 115 115 115 115 115 115 115 115 115 115 115 115 115 115 115 
115 115 115 115 115 115 115 115 115 115 115 115 115 115 115 115 115 115 115 115 115 115 115 115 115 115 115 115 115 115 115 115 115 115 115 115 115 115 115 115 115 115 115 115 115 115 115 115 115 115 
115 115 115 115 115 115 115 115 115 115 115 115 115 115 102 100 100 100 100 100 100 100 100 100 100 100 100 100 100 100 100 100 100 100 101 115 115 115 115 115 115 115 115 115 115 115 115 115 115 115 
115 115 115 115 115 115 115 115 115 115 115 115 115 115 106 116 116 116 116 116 116 116 116 116 116 116 116 116 116 116 116 116 116 116 107 115 115 115 115 115 115 115 115 115 115 115 115 115 115 115 
115 115 115 115 115 115 115 115 115 115 115 115 115 115 106 93 93 93 93 93 93 93 93 93 93 93 93 93 93 93 93 93 93 93 107 115 115 115 115 115 115 115 115 115 115 115 115 115 115 115 
115 115 115 115 115 115 115 115 115 115 115 115 115 115 106 95 127 127 95 118 119 120 95 95 95 95 95 95 95 95 95 96 96 96 107 115 115 115 115 115 115 115 115 115 115 115 115 115 115 115 
115 115 115 115 115 115 115 115 115 115 115 115 115 115 106 95 128 128 95 121 122 123 95 95 95 95 95 95 95 95 96 96 96 96 107 115 115 115 115 115 115 115 115 115 115 115 115 115 115 115 
115 115 115 115 115 115 115 115 115 115 115 115 115 115 106 118 119 119 120 121 122 123 95 95 95 95 95 95 95 95 95 96 95 95 107 115 115 115 115 115 115 115 115 115 115 115 115 115 115 115 
115 115 115 115 115 115 115 115 115 115 115 115 115 115 106 121 122 122 123 124 125 126 95 95 95 95 95 96 95 96 95 95 95 95 107 115 115 115 115 115 115 115 115 115 115 115 115 115 115 115 
115 115 115 115 115 115 115 115 115 115 115 115 115 115 106 124 125 125 126 95 95 95 96 95 95 95 95 96 95 95 95 95 95 95 107 115 115 115 115 115 115 115 115 115 115 115 115 115 115 115 
115 115 115 115 115 115 115 115 115 115 115 115 115 115 106 95 95 95 96 96 95 95 95 95 95 95 95 95 95 95 95 95 95 95 107 115 115 115 115 115 115 115 115 115 115 115 115 115 115 115 
115 115 115 115 115 115 115 115 115 102 100 100 100 100 103 95 95 95 95 96 95 95 95 95 95 95 95 95 95 95 95 95 95 95 104 100 100 100 100 100 100 101 115 115 115 115 115 115 115 115 
115 115 115 115 115 115 115 115 115 106 116 116 116 116 116 95 95 95 95 96 95 96 96 95 96 95 95 95 95 95 95 95 95 95 116 116 116 116 116 116 116 107 115 115 115 115 115 115 115 115 
115 115 115 115 115 115 115 115 115 106 93 93 93 93 93 95 96 95 95 95 95 95 95 95 95 95 95 96 95 95 96 95 96 95 93 93 93 93 93 93 93 107 115 115 115 115 115 115 115 115 
115 115 115 115 115 115 115 115 115 106 95 95 95 95 95 95 95 96 95 95 95 96 95 95 95 95 95 95 95 95 96 95 96 95 96 96 96 96 96 96 96 107 115 115 115 115 115 115 115 115 
115 115 115 115 115 115 115 115 115 106 95 95 96 95 96 95 96 95 95 95 95 95 95 95 95 95 95 95 95 95 95 95 96 96 96 95 96 96 96 96 95 107 115 115 115 115 115 115 115 115 
115 115 115 115 115 115 115 115 115 106 95 95 96 96 96 96 96 95 118 119 119 119 119 119 119 119 119 119 119 119 119 120 95 95 96 96 96 96 96 96 95 107 115 115 115 115 115 115 115 115 
115 115 115 115 115 115 115 115 115 106 95 95 95 96 96 95 95 95 121 122 122 122 122 122 122 122 122 122 122 122 122 123 96 95 96 96 96 96 96 95 95 107 115 115 115 115 115 115 115 115 
115 115 115 115 115 115 115 115 115 106 95 95 95 96 95 96 95 95 121 122 122 122 122 122 122 122 122 122 122 122 122 123 96 95 96 96 96 96 96 95 95 107 115 115 115 115 115 115 115 115 
115 115 115 115 115 115 115 115 115 106 95 95 96 96 96 96 95 95 121 122 122 122 122 122 122 122 122 122 122 122 122 123 95 96 96 96 96 96 96 95 95 107 115 115 115 115 115 115 115 115 
115 115 115 115 115 115 115 115 115 106 95 95 96 96 95 96 95 95 124 125 125 125 125 125 125 125 125 125 125 125 125 126 95 95 96 96 96 96 96 95 95 107 115 115 115 115 115 115 115 115 
115 115 115 115 115 115 115 115 115 106 95 95 96 96 95 95 96 95 95 95 95 95 95 96 96 96 95 95 95 96 95 95 95 95 96 96 96 96 95 95 95 107 115 115 115 115 115 115 115 115 
115 115 115 115 115 115 115 115 115 106 95 95 95 95 96 96 96 95 95 95 96 96 96 96 96 96 96 95 95 96 96 95 95 95 95 95 95 95 95 95 95 107 115 115 115 115 115 115 115 115 
115 115 115 115 115 115 115 115 115 106 95 95 95 96 96 96 96 96 95 95 95 95 95 96 96 96 95 95 95 95 95 95 95 95 95 95 95 95 95 95 95 107 115 115 115 115 115 115 115 115 
115 115 115 115 115 115 115 115 115 108 113 113 113 113 113 113 113 113 113 113 113 113 113 109 96 110 113 113 113 113 113 113 113 113 113 113 113 113 113 113 113 111 115 115 115 115 115 115 115 115 
115 115 115 115 115 115 115 115 115 115 115 115 115 115 115 115 115 115 115 115 115 115 115 112 113 114 115 115 115 115 115 115 115 115 115 115 115 115 115 115 115 115 115 115 115 115 115 115 115 115 
115 115 115 115 115 115 115 115 115 115 115 115 115 115 115 115 115 115 115 115 115 115 115 115 115 115 115 115 115 115 115 115 115 115 115 115 115 115 115 115 115 115 115 115 115 115 115 115 115 115 
115 115 115 115 115 115 115 115 115 115 115 115 115 115 115 115 115 115 115 115 115 115 115 115 115 115 115 115 115 115 115 115 115 115 115 115 115 115 115 115 115 115 115 115 115 115 115 115 115 115 
115 115 115 115 115 115 115 115 115 115 115 115 115 115 115 115 115 115 115 115 115 115 115 115 115 115 115 115 115 115 115 115 115 115 115 115 115 115 115 115 115 115 115 115 115 115 115 115 115 115 
115 115 115 115 115 115 115 115 115 115 115 115 115 115 115 115 115 115 115 115 115 115 115 115 115 115 115 115 115 115 115 115 115 115 115 115 115 115 115 115 115 115 115 115 115 115 115 115 115 115 
115 115 115 115 115 115 115 115 115 115 115 115 115 115 115 115 115 115 115 115 115 115 115 115 115 115 115 115 115 115 115 115 115 115 115 115 115 115 115 115 115 115 115 115 115 115 115 115 115 115 
115 115 115 115 115 115 115 115 115 115 115 115 115 115 115 115 115 115 115 115 115 115 115 115 115 115 115 115 115 115 115 115 115 115 115 115 115 115 115 115 115 115 115 115 115 115 115 115 115 115 
115 115 115 115 115 115 115 115 115 115 115 115 115 115 115 115 115 115 115 115 115 115 115 115 115 115 115 115 115 115 115 115 115 115 115 115 115 115 115 115 115 115 115 115 115 115 115 115 115 115 
115 115 115 115 115 115 115 115 115 115 115 115 115 115 115 115 115 115 115 115 115 115 115 115 115 115 115 115 115 115 115 115 115 115 115 115 115 115 115 115 115 115 115 115 115 115 115 115 115 115 
115 115 115 115 115 115 115 115 115 115 115 115 115 115 115 115 115 115 115 115 115 115 115 115 115 115 115 115 115 115 115 115 115 115 115 115 115 115 115 115 115 115 115 115 115 115 115 115 115 115 
115 115 115 115 115 115 115 115 115 115 115 115 115 115 115 115 115 115 115 115 115 115 115 115 115 115 115 115 115 115 115 115 115 115 115 115 115 115 115 115 115 115 115 115 115 115 115 115 115 115 
115 115 115 115 115 115 115 115 115 115 115 115 115 115 115 115 115 115 115 115 115 115 115 115 115 115 115 115 115 115 115 115 115 115 115 115 115 115 115 115 115 115 115 115 115 115 115 115 115 115 
115 115 115 115 115 115 115 115 115 115 115 115 115 115 115 115 115 115 115 115 115 115 115 115 115 115 115 115 115 115 115 115 115 115 115 115 115 115 115 115 115 115 115 115 115 115 115 115 115 115 
115 115 115 115 115 115 115 115 115 115 115 115 115 115 115 115 115 115 115 115 115 115 115 115 115 115 115 115 115 115 115 115 115 115 115 115 115 115 115 115 115 115 115 115 115 115 115 115 115 115 
115 115 115 115 115 115 115 115 115 115 115 115 115 115 115 115 115 115 115 115 115 115 115 115 115 115 115 115 115 115 115 115 115 115 115 115 115 115 115 115 115 115 115 115 115 115 115 115 115 115 
115 115 115 115 115 115 115 115 115 115 115 115 115 115 115 115 115 115 115 115 115 115 115 115 115 115 115 115 115 115 115 115 115 115 115 115 115 115 115 115 115 115 115 115 115 115 115 115 115 115 
115 115 115 115 115 115 115 115 115 115 115 115 115 115 115 115 115 115 115 115 115 115 115 115 115 115 115 115 115 115 115 115 115 115 115 115 115 115 115 115 115 115 115 115 115 115 115 115 115 115 
