80 80 80 80 80 80 80 80 80 80 80 80 80 80 80 80 80 80 80 80 80 80 80 80 80 80 80 80 80 80 80 80 80 80 80 80 80 80 80 80 80 80 80 80 80 80 80 80 80 80 
81 2 2 0 40 0 0 0 0 0 0 0 0 0 2 0 2 2 16 16 16 2 2 2 0 0 0 2 2 0 0 0 0 0 0 0 0 0 0 2 0 0 0 0 0 0 41 41 38 84 
81 40 0 40 40 0 0 0 0 0 0 40 0 0 0 0 39 0 16 16 16 2 2 0 0 0 0 0 0 3 3 0 0 0 3 3 0 0 2 2 0 0 0 0 0 0 3 3 38 84 
81 0 40 0 0 0 0 0 0 0 0 0 40 40 0 39 39 0 16 16 16 2 2 3 3 0 0 0 0 3 3 0 0 0 0 0 2 0 0 2 2 2 0 0 0 0 3 3 38 84 
81 40 0 0 40 2 2 0 16 0 0 0 0 0 0 39 0 0 16 16 16 2 0 3 3 0 0 0 0 0 16 16 38 38 41 2 2 0 0 0 0 0 0 0 0 2 2 0 41 84 
81 0 0 40 0 0 0 16 41 16 0 0 0 0 0 2 0 0 41 41 38 38 3 0 0 0 0 0 2 16 16 41 41 38 41 2 2 0 0 0 0 0 0 1 2 2 0 38 16 84 
81 0 0 0 0 0 16 41 2 41 16 0 0 0 0 2 0 0 41 41 38 38 38 0 0 2 2 0 2 16 41 41 41 38 41 0 0 0 0 2 2 0 0 2 2 0 38 41 41 84 
81 0 0 0 0 16 41 0 0 0 41 16 0 0 0 2 2 0 0 0 0 16 38 0 0 0 0 0 0 41 38 38 0 0 16 16 16 41 41 0 2 0 0 0 0 0 41 0 38 84 
81 0 0 2 0 0 16 41 2 41 16 0 0 0 0 0 0 0 0 0 2 0 0 3 3 3 3 0 0 16 0 38 38 0 0 16 16 16 16 41 16 0 0 0 16 41 0 0 41 84 
81 0 40 40 0 0 0 16 41 16 0 0 0 2 0 0 0 0 0 0 0 0 0 0 0 0 0 0 0 16 41 41 38 0 0 0 0 0 0 41 16 0 0 0 16 41 0 0 41 84 
81 0 0 0 0 2 0 0 16 0 0 0 2 0 0 0 16 0 0 0 0 0 0 0 0 0 0 0 16 16 41 38 38 0 0 0 0 0 0 41 16 0 0 0 16 41 0 16 16 84 
81 0 0 0 0 0 0 0 0 0 0 0 40 40 0 0 41 41 41 38 38 16 82 16 16 38 38 82 16 41 41 0 0 0 0 0 0 0 0 0 16 0 2 0 16 0 0 41 41 84 
81 0 40 0 2 0 0 39 0 0 0 40 40 0 0 0 16 16 41 38 38 16 0 16 38 38 16 0 41 41 16 0 38 38 16 0 16 0 0 0 16 2 2 0 16 2 2 0 38 84 
81 0 0 0 0 39 0 0 0 0 39 40 39 0 0 0 16 16 41 38 38 0 60 61 62 0 41 38 16 16 38 38 38 16 16 16 16 16 0 41 2 0 0 0 41 0 2 0 38 84 
81 0 2 2 0 0 0 0 0 0 0 0 0 1 0 1 16 16 41 38 38 16 63 64 65 66 41 38 38 16 16 16 16 16 16 16 16 41 41 0 0 0 0 41 0 0 2 0 38 84 
81 0 2 16 0 2 0 0 0 0 0 0 0 0 0 0 82 16 41 41 16 16 67 68 69 70 41 3 3 3 3 3 3 3 3 3 3 3 3 0 2 0 0 0 0 0 2 0 41 84 
81 16 16 16 2 38 38 41 41 41 2 2 0 0 0 16 82 0 41 41 16 16 71 72 73 74 86 3 3 3 3 3 3 3 3 3 3 3 3 0 2 2 2 2 2 2 0 2 41 84 
81 16 16 16 16 38 38 41 41 41 38 38 16 16 16 16 0 0 0 41 16 16 0 0 0 0 0 0 0 16 16 16 16 16 16 16 16 41 41 41 41 38 38 38 38 38 38 41 41 84 
81 48 48 48 48 48 48 48 48 48 48 49 2 16 16 0 0 0 0 16 84 8 3 3 3 7 81 16 16 0 16 16 38 0 16 16 16 16 0 20 21 21 21 21 21 21 21 21 21 0 
81 59 59 59 59 59 59 87 59 59 59 51 41 0 0 0 0 41 41 16 84 8 3 3 3 7 81 0 0 16 16 0 38 38 38 38 38 16 0 23 19 19 19 19 19 45 19 44 45 0 
81 59 59 59 59 88 59 59 59 59 59 51 41 0 0 0 0 41 41 16 84 8 3 3 3 7 81 0 0 0 0 0 0 0 0 0 0 0 0 23 44 19 46 19 19 19 43 46 45 0 
81 59 59 59 59 59 59 59 88 87 59 51 0 0 0 38 38 0 0 16 84 8 3 3 3 7 81 0 0 0 0 0 0 0 0 0 0 0 0 23 19 19 19 19 19 19 19 19 45 0 
81 59 59 59 59 59 59 59 87 59 59 51 0 0 0 0 0 0 0 16 84 8 3 3 3 7 81 0 0 0 0 0 0 0 0 0 0 0 0 23 19 46 43 19 19 19 45 19 43 0 
81 59 59 59 59 59 59 59 59 59 59 51 41 0 0 0 0 0 0 41 84 8 3 3 3 7 81 0 0 0 0 0 0 0 0 0 0 0 0 23 19 46 46 19 46 19 19 43 19 0 
81 59 59 59 59 87 59 59 59 59 59 51 41 0 0 38 16 0 0 41 84 8 3 3 3 7 81 0 0 0 0 0 0 0 0 0 0 0 0 23 19 19 19 19 43 19 19 19 19 0 
81 59 59 59 59 59 59 59 59 59 59 51 41 16 16 16 38 41 38 16 84 8 3 3 3 7 81 0 0 0 0 0 0 0 0 0 0 0 0 23 44 19 19 19 19 19 19 19 19 0 
81 59 59 87 59 59 59 59 59 59 59 51 0 0 80 80 80 80 80 80 85 8 3 3 3 7 78 80 80 80 80 80 80 80 80 80 80 0 0 23 19 19 19 19 19 43 19 46 19 0 
81 59 59 59 59 59 59 59 87 59 59 56 48 48 10 10 10 10 10 10 10 11 3 3 3 9 10 10 10 10 10 10 10 10 10 10 10 13 0 23 19 46 19 19 19 19 19 19 19 0 
81 59 59 59 59 59 59 59 59 59 59 59 59 59 3 3 3 3 3 3 3 3 3 3 3 3 3 3 3 3 3 3 3 3 3 3 3 7 0 25 26 26 29 46 19 46 19 46 19 0 
81 59 59 88 59 59 59 87 59 59 59 88 59 59 3 3 3 3 3 3 3 3 3 3 3 3 3 3 3 3 3 3 3 3 3 3 3 7 0 0 0 0 75 46 45 46 46 19 19 0 
81 59 59 59 59 59 59 59 59 59 88 59 59 59 3 3 3 3 3 3 3 3 3 3 3 3 3 3 3 3 3 3 3 3 3 3 3 7 0 20 21 21 31 46 19 19 46 19 19 0 
81 59 59 87 59 59 59 59 59 59 59 58 53 53 83 83 83 83 83 83 83 6 3 3 3 4 83 83 83 83 83 83 83 83 83 83 83 0 0 23 43 19 45 19 19 19 46 19 19 0 
81 59 59 59 59 59 59 59 59 59 59 51 39 0 0 0 0 0 0 40 84 8 3 3 3 7 81 0 0 0 0 0 0 0 0 0 0 0 0 23 44 19 19 19 19 46 46 19 19 0 
81 59 59 59 59 88 59 87 59 59 59 51 0 16 0 0 16 0 41 0 84 8 3 3 3 7 81 16 16 16 16 16 16 0 0 0 0 0 0 23 43 19 19 19 46 46 19 19 19 0 
81 59 59 59 59 59 59 59 59 59 59 51 0 16 0 0 0 40 41 0 84 8 3 3 3 7 81 16 16 16 16 82 82 0 0 0 0 0 0 23 19 19 45 19 46 19 19 19 19 0 
81 59 88 59 59 59 59 59 59 59 59 51 0 39 0 16 16 0 41 41 84 8 3 3 3 7 81 16 16 16 16 82 82 0 20 21 21 21 21 31 19 45 45 19 46 19 19 19 19 0 
81 59 59 59 59 59 59 59 59 59 59 51 39 40 39 0 38 0 40 0 84 8 3 3 3 7 81 16 0 16 16 82 16 0 23 19 19 19 46 46 46 46 45 46 46 46 46 45 46 0 
81 87 59 59 59 87 59 59 59 59 59 51 38 38 0 0 16 16 0 40 84 8 3 3 3 7 81 16 82 82 82 82 16 0 23 44 44 19 19 19 45 19 19 19 19 19 19 46 19 0 
81 59 59 59 88 59 59 59 59 59 59 51 38 38 0 16 38 16 16 38 41 41 3 3 3 41 41 38 16 16 16 16 0 0 23 43 44 19 19 19 45 19 19 19 19 19 46 44 19 0 
81 59 87 59 59 59 59 59 59 59 59 51 0 0 0 16 16 16 16 16 16 8 3 3 3 7 16 38 16 16 16 16 0 0 23 19 19 19 46 46 46 19 19 19 19 19 46 19 19 0 
81 59 59 59 59 59 59 59 59 59 59 51 0 0 0 38 16 1 1 0 0 14 5 5 5 0 0 0 0 1 16 16 0 0 23 19 45 19 46 19 19 19 19 19 44 19 19 19 45 0 
81 59 59 59 59 59 59 59 87 59 59 51 0 0 0 16 16 2 0 0 0 0 0 0 0 0 0 0 1 1 16 38 0 0 23 19 45 19 46 45 19 19 19 19 19 44 19 19 45 0 
81 59 59 59 59 59 59 88 59 59 87 51 0 0 0 16 16 0 0 0 0 0 0 0 0 0 0 0 1 2 16 16 0 0 23 19 19 19 46 45 45 28 26 29 19 19 19 45 19 0 
81 59 59 59 59 59 59 59 59 59 59 51 0 0 0 38 16 2 0 0 0 0 89 90 91 0 0 0 1 39 16 16 0 0 23 19 19 19 19 45 45 76 1 23 19 19 19 19 44 0 
81 88 59 88 59 59 59 59 88 59 59 51 0 0 0 16 16 39 0 0 0 0 0 0 0 0 0 0 0 39 38 16 0 0 23 19 19 19 19 19 19 30 21 31 19 19 46 44 19 0 
81 59 59 59 59 87 59 59 59 59 59 51 0 0 0 16 38 39 0 2 0 0 0 0 0 0 2 0 0 39 16 16 0 0 23 19 19 46 19 19 19 19 19 19 19 19 19 46 19 0 
81 59 59 59 59 88 59 59 87 59 88 51 41 0 41 38 16 39 41 20 21 21 21 21 21 21 21 22 39 39 16 16 0 0 23 19 19 19 19 19 46 19 46 19 19 19 46 19 45 0 
81 87 59 87 59 59 59 59 59 59 59 51 41 0 41 16 16 39 39 23 45 19 19 19 19 19 45 24 39 39 16 38 0 0 25 26 26 26 26 26 26 26 26 26 26 26 26 26 26 0 
81 59 59 59 59 59 59 59 59 59 59 51 41 41 41 38 38 39 39 23 45 46 19 19 19 46 19 24 41 39 16 16 0 0 0 0 0 0 0 0 0 0 0 0 0 0 0 0 0 84 
78 80 80 80 80 80 80 80 80 80 80 80 80 80 80 16 38 16 38 23 45 19 19 19 43 19 19 24 38 38 38 16 80 80 80 80 80 80 80 80 80 80 80 80 80 80 80 80 80 85 
