115 115 115 115 115 115 115 115 115 115 115 115 115 115 115 115 115 115 115 115 115 115 115 115 115 115 115 115 115 115 115 115 115 115 115 115 115 115 115 115 115 115 115 115 115 115 115 115 115 115 
115 115 115 115 115 115 115 115 115 115 115 115 115 115 115 115 115 115 115 115 115 115 115 115 115 115 115 115 115 115 115 115 115 115 115 115 115 115 115 115 115 115 115 115 115 115 115 115 115 115 
115 115 115 115 115 115 115 115 115 115 115 115 115 115 115 115 115 115 115 115 115 115 115 115 115 115 115 115 115 115 115 115 115 115 115 115 115 115 115 115 115 115 115 115 115 115 115 115 115 115 
115 115 115 115 115 115 115 115 115 115 115 115 115 115 115 115 115 115 115 115 115 115 115 115 115 115 115 115 115 115 115 115 115 115 115 115 115 115 115 115 115 115 115 115 115 115 115 115 115 115 
115 115 115 115 115 115 115 115 115 115 115 115 115 115 115 115 115 115 115 115 115 115 115 115 115 115 115 115 115 115 115 115 115 115 115 115 115 115 115 115 115 115 115 115 115 115 115 115 115 115 
115 115 115 115 115 115 115 115 115 115 115 115 115 115 115 115 115 115 115 115 115 115 115 115 115 115 115 115 115 115 115 115 115 115 115 115 115 115 115 115 115 115 115 115 115 115 115 115 115 115 
115 115 115 115 115 115 115 115 115 115 115 115 115 115 115 115 115 115 115 115 115 115 115 115 115 115 115 115 115 115 115 115 115 115 115 115 115 115 115 115 115 115 115 115 115 115 115 115 115 115 
115 115 115 115 115 115 115 115 115 115 115 115 115 115 115 115 115 115 115 115 115 115 115 115 115 115 115 115 115 115 115 115 115 115 115 115 115 115 115 115 115 115 115 115 115 115 115 115 115 115 
115 115 115 115 115 115 115 115 115 115 115 115 115 115 115 115 115 115 115 115 115 115 115 115 115 115 115 115 115 115 115 115 115 115 115 115 115 115 115 115 115 115 115 115 115 115 115 115 115 115 
115 115 115 115 115 115 115 115 115 115 115 115 115 115 115 115 115 115 115 115 115 115 115 115 115 115 115 115 115 115 115 115 115 115 115 115 115 115 115 115 115 115 115 115 115 115 115 115 115 115 
115 115 115 115 115 115 115 115 115 115 115 115 115 115 102 100 100 100 100 100 100 100 100 100 100 100 100 100 100 100 100 100 100 100 101 115 115 115 115 115 115 115 115 115 115 115 115 115 115 115 
115 115 115 115 115 115 115 115 115 115 115 115 115 115 106 116 116 116 116 116 116 116 116 140 141 140 141 136 137 136 137 116 116 116 107 115 115 115 115 115 115 115 115 115 115 115 115 115 115 115 
115 115 115 115 115 115 115 115 115 115 115 115 115 115 106 93 93 93 93 93 93 93 93 142 143 142 143 138 139 138 139 93 93 93 107 115 115 115 115 115 115 115 115 115 115 115 115 115 115 115 
115 115 115 115 115 115 115 115 115 115 115 115 115 115 106 95 127 127 95 118 119 120 95 95 95 95 95 95 95 95 95 161 132 133 107 115 115 115 115 115 115 115 115 115 115 115 115 115 115 115 
115 115 115 115 115 115 115 115 115 115 115 115 115 115 106 95 128 128 95 121 122 123 95 95 95 95 95 95 95 95 96 161 134 135 107 115 115 115 115 115 115 115 115 115 115 115 115 115 115 115 
115 115 115 115 115 115 115 115 115 115 115 115 115 115 106 118 119 119 120 121 122 123 95 95 95 95 95 95 95 95 95 96 95 95 107 115 115 115 115 115 115 115 115 115 115 115 115 115 115 115 
115 115 115 115 115 115 115 115 115 115 115 115 115 115 106 121 122 122 123 124 125 126 95 95 95 95 95 96 95 96 95 95 95 95 107 115 115 115 115 115 115 115 115 115 115 115 115 115 115 115 
115 115 115 115 115 115 115 115 115 115 115 115 115 115 106 124 125 125 126 95 95 95 96 95 95 95 95 96 95 95 95 95 95 95 107 115 115 115 115 115 115 115 115 115 115 115 115 115 115 115 
115 115 115 115 115 115 115 115 115 115 115 115 115 115 106 95 95 95 96 96 95 95 95 95 95 95 95 95 95 95 95 95 95 95 107 115 115 115 115 115 115 115 115 115 115 115 115 115 115 115 
115 115 115 115 115 115 115 115 115 102 100 100 100 100 103 95 95 95 95 96 95 95 95 95 95 95 95 95 95 95 95 95 95 95 104 100 100 100 100 100 100 101 115 115 115 115 115 115 115 115 
115 115 115 115 115 115 115 115 115 106 140 141 136 137 116 95 95 95 95 96 95 96 96 95 96 95 95 95 95 95 95 95 95 95 116 154 116 116 154 116 116 107 115 115 115 115 115 115 115 115 
115 115 115 115 115 115 115 115 115 106 142 143 138 139 93 95 96 95 95 95 95 95 95 95 95 95 95 96 95 95 96 95 96 95 155 156 157 155 156 157 93 107 115 115 115 115 115 115 115 115 
115 115 115 115 115 115 115 115 115 106 95 95 95 95 95 95 95 96 95 95 95 96 95 95 95 95 95 95 95 95 96 95 96 95 158 159 160 158 159 160 153 107 115 115 115 115 115 115 115 115 
115 115 115 115 115 115 115 115 115 106 95 95 96 95 96 95 96 95 95 95 95 95 95 95 95 95 95 95 95 95 95 95 96 96 96 95 96 96 96 96 95 107 115 115 115 115 115 115 115 115 
115 115 115 115 115 115 115 115 115 106 95 95 96 96 96 96 96 95 118 119 119 119 119 119 119 119 119 119 119 119 119 120 95 95 96 144 145 146 96 96 95 107 115 115 115 115 115 115 115 115 
115 115 115 115 115 115 115 115 115 106 95 95 95 132 133 153 95 95 121 122 122 122 122 122 122 122 122 122 122 122 122 123 96 95 153 147 148 149 153 95 95 107 115 115 115 115 115 115 115 115 
115 115 115 115 115 115 115 115 115 106 95 95 153 134 135 95 95 95 121 122 122 122 122 122 122 122 122 122 122 122 122 123 96 95 153 147 148 149 153 95 95 107 115 115 115 115 115 115 115 115 
115 115 115 115 115 115 115 115 115 106 95 95 96 96 96 96 95 95 121 122 122 122 122 122 122 122 122 122 122 122 122 123 95 96 153 147 148 149 153 95 95 107 115 115 115 115 115 115 115 115 
115 115 115 115 115 115 115 115 115 106 95 95 96 96 95 96 95 95 124 125 125 125 125 125 125 125 125 125 125 125 125 126 95 95 153 147 148 149 153 95 95 107 115 115 115 115 115 115 115 115 
115 115 115 115 115 115 115 115 115 106 95 95 96 96 95 95 96 95 95 95 95 95 95 96 96 96 95 95 95 96 95 95 95 95 95 150 151 152 95 95 95 107 115 115 115 115 115 115 115 115 
115 115 115 115 115 115 115 115 115 106 95 95 95 144 145 145 146 95 95 95 96 96 96 96 96 96 96 95 95 96 96 95 95 95 95 95 95 95 95 95 95 107 115 115 115 115 115 115 115 115 
115 115 115 115 115 115 115 115 115 106 95 95 95 147 148 148 149 95 95 95 95 95 95 96 96 96 95 95 95 95 95 95 95 95 95 95 95 95 95 95 95 107 115 115 115 115 115 115 115 115 
115 115 115 115 115 115 115 115 115 108 113 113 113 113 113 113 113 113 113 113 113 113 113 109 96 110 113 113 113 113 113 113 113 113 113 113 113 113 113 113 113 111 115 115 115 115 115 115 115 115 
115 115 115 115 115 115 115 115 115 115 115 115 115 115 115 115 115 115 115 115 115 115 115 112 113 114 115 115 115 115 115 115 115 115 115 115 115 115 115 115 115 115 115 115 115 115 115 115 115 115 
115 115 115 115 115 115 115 115 115 115 115 115 115 115 115 115 115 115 115 115 115 115 115 115 115 115 115 115 115 115 115 115 115 115 115 115 115 115 115 115 115 115 115 115 115 115 115 115 115 115 
115 115 115 115 115 115 115 115 115 115 115 115 115 115 115 115 115 115 115 115 115 115 115 115 115 115 115 115 115 115 115 115 115 115 115 115 115 115 115 115 115 115 115 115 115 115 115 115 115 115 
115 115 115 115 115 115 115 115 115 115 115 115 115 115 115 115 115 115 115 115 115 115 115 115 115 115 115 115 115 115 115 115 115 115 115 115 115 115 115 115 115 115 115 115 115 115 115 115 115 115 
115 115 115 115 115 115 115 115 115 115 115 115 115 115 115 115 115 115 115 115 115 115 115 115 115 115 115 115 115 115 115 115 115 115 115 115 115 115 115 115 115 115 115 115 115 115 115 115 115 115 
115 115 115 115 115 115 115 115 115 115 115 115 115 115 115 115 115 115 115 115 115 115 115 115 115 115 115 115 115 115 115 115 115 115 115 115 115 115 115 115 115 115 115 115 115 115 115 115 115 115 
115 115 115 115 115 115 115 115 115 115 115 115 115 115 115 115 115 115 115 115 115 115 115 115 115 115 115 115 115 115 115 115 115 115 115 115 115 115 115 115 115 115 115 115 115 115 115 115 115 115 
115 115 115 115 115 115 115 115 115 115 115 115 115 115 115 115 115 115 115 115 115 115 115 115 115 115 115 115 115 115 115 115 115 115 115 115 115 115 115 115 115 115 115 115 115 115 115 115 115 115 
115 115 115 115 115 115 115 115 115 115 115 115 115 115 115 115 115 115 115 115 115 115 115 115 115 115 115 115 115 115 115 115 115 115 115 115 115 115 115 115 115 115 115 115 115 115 115 115 115 115 
115 115 115 115 115 115 115 115 115 115 115 115 115 115 115 115 115 115 115 115 115 115 115 115 115 115 115 115 115 115 115 115 115 115 115 115 115 115 115 115 115 115 115 115 115 115 115 115 115 115 
115 115 115 115 115 115 115 115 115 115 115 115 115 115 115 115 115 115 115 115 115 115 115 115 115 115 115 115 115 115 115 115 115 115 115 115 115 115 115 115 115 115 115 115 115 115 115 115 115 115 
115 115 115 115 115 115 115 115 115 115 115 115 115 115 115 115 115 115 115 115 115 115 115 115 115 115 115 115 115 115 115 115 115 115 115 115 115 115 115 115 115 115 115 115 115 115 115 115 115 115 
115 115 115 115 115 115 115 115 115 115 115 115 115 115 115 115 115 115 115 115 115 115 115 115 115 115 115 115 115 115 115 115 115 115 115 115 115 115 115 115 115 115 115 115 115 115 115 115 115 115 
115 115 115 115 115 115 115 115 115 115 115 115 115 115 115 115 115 115 115 115 115 115 115 115 115 115 115 115 115 115 115 115 115 115 115 115 115 115 115 115 115 115 115 115 115 115 115 115 115 115 
115 115 115 115 115 115 115 115 115 115 115 115 115 115 115 115 115 115 115 115 115 115 115 115 115 115 115 115 115 115 115 115 115 115 115 115 115 115 115 115 115 115 115 115 115 115 115 115 115 115 
115 115 115 115 115 115 115 115 115 115 115 115 115 115 115 115 115 115 115 115 115 115 115 115 115 115 115 115 115 115 115 115 115 115 115 115 115 115 115 115 115 115 115 115 115 115 115 115 115 115 
115 115 115 115 115 115 115 115 115 115 115 115 115 115 115 115 115 115 115 115 115 115 115 115 115 115 115 115 115 115 115 115 115 115 115 115 115 115 115 115 115 115 115 115 115 115 115 115 115 115 
